{
  "name": "Test Map",
  "width": 10,
  "height": 10,
  "tiles": [
    0, 1, 0, 1, 0, 1, 0, 0, 0, 0,
    0, 1, 0, 1, 0, 0, 0, 0, 0, 0,
    0, 1, 1, 1, 0, 1, 0, 0, 0, 0,
    0, 1, 0, 1, 0, 1, 0, 0, 0, 0,
    0, 0, 0, 0, 0, 0, 0, 0, 0, 0,
    0, 1, 1, 1, 0, 1, 1, 1, 0, 0,
    0, 1, 0, 0, 0, 1, 0, 1, 0, 0,
    0, 1, 1, 0, 0, 1, 1, 1, 0, 0,
    0, 1, 0, 0, 0, 1, 0, 0, 1, 0,
    0, 0, 0, 0, 0, 0, 0, 0, 0, 0
  ]
}